Rk,Player,School,Conf,G,Rec,RecYds,RecAvg,RecTD,RushAtt,RushYds,RushAvg,RushTD,Plays,TotalYds,YardsPerPlay,TotalTDs
1,Mack Hollins,North Carolina,ACC,13,30,745,24.8,8,0,0,,0,30,745,24.8,8
2,Shelton Gibson,West Virginia,Big 12,12,37,887,24.0,9,0,0,,0,37,887,24.0,9
3,Cody Thompson,Toledo,MAC,12,37,825,22.3,5,0,0,,0,37,825,22.3,5
4,Josh Magee,South Alabama,Sun Belt,12,23,504,21.9,3,1,-2,-2.0,0,24,502,20.9,3
5,Chris Moore,Cincinnati,American,11,40,870,21.8,7,2,10,5.0,0,42,880,21.0,7
6,Ricky Jeune,Georgia Tech,ACC,11,24,520,21.7,4,0,0,,0,24,520,21.7,4
7,Carlos Henderson,Louisiana Tech,CUSA,11,36,774,21.5,5,5,54,10.8,0,41,828,20.2,5
8,Bryce Treggs,California,Pac-12,13,45,956,21.2,7,0,0,,0,45,956,21.2,7
9,Terry Pettis,Middle Tennessee State,CUSA,12,29,612,21.1,4,0,0,,0,29,612,21.1,4
10,Leonte Carroo,Rutgers,Big Ten,8,39,809,20.7,10,0,0,,0,39,809,20.7,10
11,Jamir Tillman,Navy,American,12,29,597,20.6,5,2,10,5.0,0,31,607,19.6,5
12,Garrett Brown,Air Force,MWC,14,27,557,20.6,1,35,259,7.4,1,62,816,13.2,2
13,James Washington,Oklahoma State,Big 12,13,53,1087,20.5,10,1,10,10.0,0,54,1097,20.3,10
14,William Fuller,Notre Dame,Ind,13,62,1258,20.3,14,0,0,,0,62,1258,20.3,14
15,Jerome Lane,Akron,MAC,12,39,782,20.1,8,0,0,,0,39,782,20.1,8
16,Jay Lee,Baylor,Big 12,13,38,758,19.9,8,1,-1,-1.0,0,39,757,19.4,8
17,Kolby Listenbee,TCU,Big 12,10,30,597,19.9,5,1,11,11.0,0,31,608,19.6,5
18,Michael Thomas,Southern Mississippi,CUSA,13,71,1391,19.6,14,0,0,,0,71,1391,19.6,14
19,Antonio Callaway,Florida,SEC,14,35,678,19.4,4,3,19,6.3,0,38,697,18.3,4
20,Dontez Ford,Pitt,ACC,12,26,505,19.4,2,0,0,,0,26,505,19.4,2
21,Dijon Paschal,Arkansas State,Sun Belt,11,28,541,19.3,3,1,-9,-9.0,0,29,532,18.3,3
22,Dominique Reed,Arkansas,SEC,10,28,535,19.1,6,4,24,6.0,1,32,559,17.5,7
23,Darren Carrington,Oregon,Pac-12,7,32,609,19.0,6,1,21,21.0,0,33,630,19.1,6
24,Travin Dural,LSU,SEC,9,28,533,19.0,3,3,13,4.3,0,31,546,17.6,3
25,Brandon Reilly,Nebraska,Big Ten,12,40,754,18.9,4,11,96,8.7,0,51,850,16.7,4
26,Donovan Harden,Georgia State,Sun Belt,10,38,715,18.8,5,1,-2,-2.0,0,39,713,18.3,5
27,Mekale McKay,Cincinnati,American,10,27,507,18.8,2,0,0,,0,27,507,18.8,2
28,Sam Martin,Miami (OH),MAC,10,29,542,18.7,2,0,0,,0,29,542,18.7,2
29,Gary Chambers,Arizona State,Pac-12,13,26,486,18.7,2,0,0,,0,26,486,18.7,2
30,Rodney Adams,South Florida,American,13,44,816,18.5,9,11,87,7.9,1,55,903,16.4,10
31,Malachi Jones,Appalachian State,Sun Belt,12,25,463,18.5,3,0,0,,0,25,463,18.5,3
32,Corey Coleman,Baylor,Big 12,12,74,1363,18.4,20,22,111,5.0,0,96,1474,15.4,20
33,Tanner Gentry,Wyoming,MWC,7,37,678,18.3,4,5,48,9.6,0,42,726,17.3,4
34,Roger Lewis,Bowling Green State,MAC,14,85,1544,18.2,16,0,0,,0,85,1544,18.2,16
35,Josh Reynolds,Texas A&M,SEC,12,51,907,17.8,5,0,0,,0,51,907,17.8,5
36,Tyrain Taylor,New Mexico State,Sun Belt,12,39,691,17.7,4,1,-2,-2.0,0,40,689,17.2,4
37,Courtland Sutton,SMU,American,12,49,862,17.6,9,0,0,,0,49,862,17.6,9
38,Tevaun Smith,Iowa,Big Ten,11,32,563,17.6,3,0,0,,0,32,563,17.6,3
39,K.D. Cannon,Baylor,Big 12,13,50,868,17.4,6,1,2,2.0,0,51,870,17.1,6
40,Cody Core,Ole Miss,SEC,12,37,644,17.4,4,1,1,1.0,0,38,645,17.0,4
41,Simmie Cobbs,Indiana,Big Ten,13,60,1035,17.3,4,0,0,,0,60,1035,17.3,4
42,Jamari Staples,Louisville,ACC,9,37,638,17.2,3,0,0,,0,37,638,17.2,3
43,Alonzo Russell,Toledo,MAC,12,36,618,17.2,5,0,0,,0,36,618,17.2,5
44,Justin Hobbs,Tulsa,American,11,32,551,17.2,2,3,13,4.3,0,35,564,16.1,2
45,Devon Breaux,Tulane,American,9,25,431,17.2,3,0,0,,0,25,431,17.2,3
46,Taywan Taylor,Western Kentucky,CUSA,14,86,1467,17.1,17,7,2,0.3,0,93,1469,15.8,17
47,Tres Houston,Arkansas State,Sun Belt,12,36,615,17.1,10,0,0,,0,36,615,17.1,10
48,Deon Cain,Clemson,ACC,11,34,582,17.1,5,1,-5,-5.0,0,35,577,16.5,5
49,Josh Doctson,TCU,Big 12,10,78,1326,17.0,14,2,7,3.5,0,80,1333,16.7,14
50,Marcell Ateman,Oklahoma State,Big 12,12,45,766,17.0,5,1,1,1.0,0,46,767,16.7,5
51,Brendan Cope,Ohio,MAC,10,30,510,17.0,2,0,0,,0,30,510,17.0,2
52,Ricky Jones,Indiana,Big Ten,13,54,906,16.8,5,2,20,10.0,0,56,926,16.5,5
53,Trevor Davis,California,Pac-12,13,40,672,16.8,2,3,4,1.3,0,43,676,15.7,2
54,Bug Howard,North Carolina,ACC,12,29,488,16.8,4,0,0,,0,29,488,16.8,4
55,Devonte Boyd,UNLV,MWC,12,54,904,16.7,7,0,0,,0,54,904,16.7,7
56,Keyarris Garrett,Tulsa,American,13,96,1588,16.5,8,0,0,,0,96,1588,16.5,8
57,Thomas Duarte,UCLA,Pac-12,13,53,872,16.5,10,0,0,,0,53,872,16.5,10
58,Rokeem Williams,Miami (OH),MAC,11,33,543,16.5,2,6,30,5.0,0,39,573,14.7,2
59,Michael Rector,Stanford,Pac-12,14,34,559,16.4,7,1,-6,-6.0,0,35,553,15.8,7
60,JuJu Smith-Schuster,USC,Pac-12,14,89,1454,16.3,10,1,4,4.0,0,90,1458,16.2,10
61,Devin Lucien,Arizona State,Pac-12,12,66,1074,16.3,8,0,0,,0,66,1074,16.3,8
62,Jabryce Taylor,UTSA,CUSA,12,29,472,16.3,3,0,0,,0,29,472,16.3,3
63,John Burt,Texas,Big 12,12,28,457,16.3,2,1,-2,-2.0,0,29,455,15.7,2
64,Cayleb Jones,Arizona,Pac-12,13,56,907,16.2,5,0,0,,0,56,907,16.2,5
65,Dede Westbrook,Oklahoma,Big 12,13,46,743,16.2,4,5,17,3.4,0,51,760,14.9,4
66,Malachi Dupre,LSU,SEC,12,43,698,16.2,6,0,0,,0,43,698,16.2,6
67,Jordan Bergstrom,New Mexico State,Sun Belt,9,27,437,16.2,7,0,0,,0,27,437,16.2,7
68,Corey Davis,Western Michigan,MAC,13,89,1429,16.1,12,1,11,11.0,0,90,1440,16.0,12
69,Robert Davis,Georgia State,Sun Belt,13,61,980,16.1,6,0,0,,0,61,980,16.1,6
70,Thomas Sperbeck,Boise State,MWC,13,88,1412,16.0,8,5,42,8.4,0,93,1454,15.6,8
71,Chris Godwin,Penn State,Big Ten,13,69,1101,16.0,5,0,0,,0,69,1101,16.0,5
72,James Quick,Louisville,ACC,11,39,624,16.0,5,1,8,8.0,0,40,632,15.8,5
73,Quincy Adeboyejo,Ole Miss,SEC,12,38,604,15.9,7,0,0,,0,38,604,15.9,7
74,Jordan Thompson,West Virginia,Big 12,11,32,509,15.9,0,0,0,,0,32,509,15.9,0
75,O.J. Howard,Alabama,SEC,12,38,602,15.8,2,0,0,,0,38,602,15.8,2
76,Jovon Durante,West Virginia,Big 12,12,25,395,15.8,5,0,0,,0,25,395,15.8,5
77,Ben McCord,Central Michigan,MAC,13,39,612,15.7,5,0,0,,0,39,612,15.7,5
78,Keevan Lucas,Tulsa,American,4,26,409,15.7,5,6,46,7.7,0,32,455,14.2,5
79,Ricardo Louis,Auburn,SEC,13,46,716,15.6,3,29,158,5.4,1,75,874,11.7,4
80,Marcus Kemp,Hawaii,MWC,12,36,563,15.6,2,0,0,,0,36,563,15.6,2
81,Isaiah Ford,Virginia Tech,ACC,13,75,1164,15.5,11,7,51,7.3,0,82,1215,14.8,11
82,Kenny Golladay,Northern Illinois,MAC,14,73,1129,15.5,10,9,14,1.6,1,82,1143,13.9,11
83,Travis Rudolph,Florida State,ACC,13,59,916,15.5,7,0,0,,0,59,916,15.5,7
84,Penny Hart,Georgia State,Sun Belt,13,72,1109,15.4,8,3,11,3.7,0,75,1120,14.9,8
85,Nicholas Norris,Western Kentucky,CUSA,14,63,971,15.4,6,6,63,10.5,1,69,1034,15.0,7
86,Dwayne Stanford,Oregon,Pac-12,11,30,463,15.4,5,0,2,,0,30,465,15.5,5
87,Gregory Hogan,New Mexico State,Sun Belt,12,24,370,15.4,5,0,0,,0,24,370,15.4,5
88,De'Runnya Wilson,Mississippi State,SEC,13,59,905,15.3,10,0,0,,0,59,905,15.3,10
89,Jamal Robinson,Louisiana,Sun Belt,12,54,824,15.3,5,0,0,,0,54,824,15.3,5
90,Jehu Chesson,Michigan,Big Ten,13,50,764,15.3,9,8,155,19.4,2,58,919,15.8,11
91,Jordan Villamin,Oregon State,Pac-12,12,43,660,15.3,5,0,0,,0,43,660,15.3,5
92,Adoree Jackson,USC,Pac-12,14,27,414,15.3,2,7,36,5.1,0,34,450,13.2,2
93,Donnel Pumphrey,San Diego State,MWC,14,27,414,15.3,3,309,1653,5.3,17,336,2067,6.2,20
94,Fred Brown,Mississippi State,SEC,12,27,412,15.3,3,0,0,,0,27,412,15.3,3
95,Kody Cook,Kansas State,Big 12,12,27,412,15.3,3,67,158,2.4,2,94,570,6.1,5
96,David Glidden,Oklahoma State,Big 12,13,57,866,15.2,3,0,0,,0,57,866,15.2,3
97,Herb Waters,Miami (FL),ACC,13,41,624,15.2,1,2,11,5.5,0,43,635,14.8,1
98,Corey Willis,Central Michigan,MAC,13,37,564,15.2,5,9,19,2.1,0,46,583,12.7,5
99,Da'Mari Scott,Fresno State,MWC,11,24,364,15.2,3,1,3,3.0,0,25,367,14.7,3
100,Eddie Daugherty,Eastern Michigan,MAC,12,37,557,15.1,4,5,13,2.6,0,42,570,13.6,4
101,Dennis Parks,Rice,CUSA,9,33,498,15.1,3,0,0,,0,33,498,15.1,3
102,Jared Murphy,Miami (OH),MAC,11,29,439,15.1,2,3,6,2.0,0,32,445,13.9,2
103,Sterling Shepard,Oklahoma,Big 12,13,86,1288,15.0,11,1,5,5.0,0,87,1293,14.9,11
104,Joshua Perkins,Washington,Pac-12,12,36,539,15.0,3,0,0,,0,36,539,15.0,3
105,Jerell Adams,South Carolina,SEC,12,28,421,15.0,3,0,0,,0,28,421,15.0,3
106,Malcolm Mitchell,Georgia,SEC,13,58,865,14.9,5,0,0,,0,58,865,14.9,5
107,Garrett Johnson,Kentucky,SEC,12,47,700,14.9,2,1,0,0.0,0,48,700,14.6,2
108,Devin Lauderdale,Texas Tech,Big 12,10,43,639,14.9,4,0,0,,0,43,639,14.9,4
109,Hunter Renfrow,Clemson,ACC,13,33,492,14.9,5,0,0,,0,33,492,14.9,5
110,Aaron Burbridge,Michigan State,Big Ten,14,85,1258,14.8,7,9,44,4.9,0,94,1302,13.9,7
111,Anthony Miller,Memphis,American,12,47,694,14.8,5,9,54,6.0,2,56,748,13.4,7
112,Ventell Bryant,Temple,American,14,39,579,14.8,3,1,9,9.0,0,40,588,14.7,3
113,Nick Kurtz,Brigham Young,Ind,12,39,578,14.8,3,0,0,,0,39,578,14.8,3
114,Tyler Higbee,Western Kentucky,CUSA,9,38,563,14.8,8,0,0,,0,38,563,14.8,8
115,Anthony Nash,Duke,ACC,10,32,475,14.8,1,0,0,,0,32,475,14.8,1
116,Jeff Badet,Kentucky,SEC,11,29,430,14.8,2,0,0,,0,29,430,14.8,2
117,Joe Hansley,Colorado State,MWC,13,28,415,14.8,6,3,11,3.7,0,31,426,13.7,6
118,Pharoh Cooper,South Carolina,SEC,12,66,973,14.7,8,24,111,4.6,1,90,1084,12.0,9
119,Stacy Coley,Miami (FL),ACC,11,47,689,14.7,4,1,15,15.0,0,48,704,14.7,4
120,Jenson Stoshak,Florida Atlantic,CUSA,12,56,816,14.6,2,0,0,,0,56,816,14.6,2
121,Deangelo Yancey,Purdue,Big Ten,12,48,700,14.6,5,0,0,,0,48,700,14.6,5
122,Paul Turner,Louisiana Tech,CUSA,11,45,657,14.6,3,1,7,7.0,0,46,664,14.4,3
123,Tre' Parmalee,Kansas,Big 12,10,41,599,14.6,3,4,22,5.5,1,45,621,13.8,4
124,Steve Ishmael,Syracuse,ACC,12,39,570,14.6,7,0,0,,0,39,570,14.6,7
125,Hunter Henry,Arkansas,SEC,13,51,739,14.5,3,0,0,,0,51,739,14.5,3
126,Devon Blackmon,Brigham Young,Ind,13,46,669,14.5,0,0,0,,0,46,669,14.5,0
127,Rodney Mills,Massachusetts,MAC,9,33,477,14.5,3,0,0,,0,33,477,14.5,3
128,Allen Lazard,Iowa State,Big 12,11,56,808,14.4,6,0,0,,0,56,808,14.4,6
129,KaVontae Turpin,TCU,Big 12,13,45,649,14.4,8,20,116,5.8,0,65,765,11.8,8
130,Jeremy Sprinkle,Arkansas,SEC,11,27,389,14.4,6,1,4,4.0,0,28,393,14.0,6
131,Rashard Higgins,Colorado State,MWC,12,74,1061,14.3,8,2,21,10.5,0,76,1082,14.2,8
132,Hasaan Henderson,Nevada,MWC,13,52,741,14.3,4,0,0,,0,52,741,14.3,4
133,Charone Peake,Clemson,ACC,14,50,716,14.3,5,0,0,,0,50,716,14.3,5
134,Christian McCaffrey,Stanford,Pac-12,14,45,645,14.3,5,337,2019,6.0,8,382,2664,7.0,13
135,Trent Bostick,Charlotte,CUSA,12,33,472,14.3,3,0,0,,0,33,472,14.3,3
136,D.J. Moore,Maryland,Big Ten,11,25,357,14.3,3,1,9,9.0,0,26,366,14.1,3
137,Jordan Payton,UCLA,Pac-12,13,78,1105,14.2,5,0,0,,0,78,1105,14.2,5
138,Jesse Kroll,Central Michigan,MAC,13,61,866,14.2,4,0,0,,0,61,866,14.2,4
139,D.J. Thompson,Southern Mississippi,CUSA,14,55,779,14.2,6,0,0,,0,55,779,14.2,6
140,Shay Fields,Colorado,Pac-12,10,42,598,14.2,4,2,8,4.0,0,44,606,13.8,4
141,Ian Sadler,Texas Tech,Big 12,10,42,596,14.2,3,0,0,,0,42,596,14.2,3
142,Zach Wright,Rice,CUSA,12,39,554,14.2,5,0,0,,0,39,554,14.2,5
143,Devon Cajuste,Stanford,Pac-12,12,27,383,14.2,3,0,0,,0,27,383,14.2,3
144,Jakeem Grant,Texas Tech,Big 12,13,90,1268,14.1,10,8,68,8.5,2,98,1336,13.6,12
145,Laquon Treadwell,Ole Miss,SEC,13,82,1153,14.1,11,1,-5,-5.0,0,83,1148,13.8,11
146,Joshua Atkinson,Tulsa,American,12,76,1071,14.1,5,0,0,,0,76,1071,14.1,5
147,Zach Pascal,Old Dominion,CUSA,12,69,975,14.1,8,15,165,11.0,1,84,1140,13.6,9
148,Jordan Westerkamp,Nebraska,Big Ten,13,65,918,14.1,7,0,0,,0,65,918,14.1,7
149,Canaan Severin,Virginia,ACC,12,53,747,14.1,8,0,0,,0,53,747,14.1,8
150,Reginald Davis,Texas Tech,Big 12,13,38,536,14.1,8,1,21,21.0,0,39,557,14.3,8
151,Kenneth Dixon,Louisiana Tech,CUSA,11,33,464,14.1,7,198,1073,5.4,19,231,1537,6.7,26
152,Caleb Scott,Vanderbilt,SEC,10,24,339,14.1,2,0,0,,0,24,339,14.1,2
153,Teddy Ruben,Troy,Sun Belt,12,63,879,14.0,9,2,12,6.0,0,65,891,13.7,9
154,Kermit Whitfield,Florida State,ACC,13,57,798,14.0,6,5,29,5.8,0,62,827,13.3,6
155,Gerald Everett,South Alabama,Sun Belt,12,41,575,14.0,8,8,7,0.9,4,49,582,11.9,12
156,Damore'ea Stringfellow,Ole Miss,SEC,12,36,503,14.0,5,0,0,,0,36,503,14.0,5
157,Brandon Smith,Texas State,Sun Belt,12,33,462,14.0,2,1,1,1.0,0,34,463,13.6,2
158,T.J. Thorpe,Virginia,ACC,9,23,321,14.0,1,5,28,5.6,1,28,349,12.5,2
159,Dom Williams,Washington State,Pac-12,13,75,1040,13.9,11,0,0,,0,75,1040,13.9,11
160,Michael Thomas,Ohio State,Big Ten,13,56,781,13.9,9,0,0,,0,56,781,13.9,9
161,Tre'Quan Smith,UCF,American,12,52,724,13.9,4,0,0,,0,52,724,13.9,4
162,Jordan Reid,Ohio,MAC,11,45,625,13.9,5,0,0,,0,45,625,13.9,5
163,K.J. Brent,Wake Forest,ACC,12,42,583,13.9,1,0,0,,0,42,583,13.9,1
164,Chaz Anderson,Boise State,MWC,13,42,578,13.8,3,2,12,6.0,0,44,590,13.4,3
165,Maurice Harris,California,Pac-12,13,40,553,13.8,6,0,0,,0,40,553,13.8,6
166,Dante Pettis,Washington,Pac-12,13,30,414,13.8,1,1,-8,-8.0,0,31,406,13.1,1
167,D'Ernest Johnson,South Florida,American,13,25,346,13.8,4,71,307,4.3,1,96,653,6.8,5
168,Antwan Dixon,Kent State,MAC,8,26,355,13.7,1,11,162,14.7,2,37,517,14.0,3
169,Jacob Hollister,Wyoming,MWC,10,26,355,13.7,3,0,0,,0,26,355,13.7,3
170,Geronimo Allison,Illinois,Big Ten,12,65,882,13.6,3,0,0,,0,65,882,13.6,3
171,Mitch Mathews,Brigham Young,Ind,13,54,737,13.6,11,0,0,,0,54,737,13.6,11
172,Hansel Wilson,San Jose State,MWC,13,35,475,13.6,4,6,84,14.0,0,41,559,13.6,4
173,Davon Grayson,East Carolina,American,11,33,448,13.6,3,0,0,,0,33,448,13.6,3
174,Braxton Miller,Ohio State,Big Ten,13,25,340,13.6,3,43,261,6.1,1,68,601,8.8,4
175,Jonathan Duhart,Old Dominion,CUSA,12,47,636,13.5,8,0,0,,0,47,636,13.5,8
176,Robby Anderson,Temple,American,14,70,939,13.4,7,4,15,3.8,0,74,954,12.9,7
177,Drew Morgan,Arkansas,SEC,13,63,843,13.4,10,4,20,5.0,0,67,863,12.9,10
178,Chance Allen,Houston,American,14,56,752,13.4,6,0,0,,0,56,752,13.4,6
179,Rashawn Scott,Miami (FL),ACC,12,52,695,13.4,5,0,0,,0,52,695,13.4,5
180,Teddy Veal,Tulane,American,11,48,644,13.4,5,0,1,,0,48,645,13.4,5
181,Quenton Bundrage,Iowa State,Big 12,12,41,548,13.4,4,0,0,,0,41,548,13.4,4
182,Drew Wolitarsky,Minnesota,Big Ten,13,39,524,13.4,3,0,0,,0,39,524,13.4,3
183,Keith Rucker,Georgia State,Sun Belt,10,39,522,13.4,6,0,0,,0,39,522,13.4,6
184,Deante Burton,Kansas State,Big 12,12,38,510,13.4,4,0,0,,0,38,510,13.4,4
185,Jumichael Ramos,North Carolina State,ACC,11,34,457,13.4,3,0,0,,0,34,457,13.4,3
186,Brandon Powell,Florida,SEC,13,29,390,13.4,3,14,31,2.2,0,43,421,9.8,3
187,Royce Freeman,Oregon,Pac-12,13,26,348,13.4,2,283,1836,6.5,17,309,2184,7.1,19
188,Noel Thomas,Connecticut,American,12,54,719,13.3,3,5,22,4.4,0,59,741,12.6,3
189,T.J. Rahming,Duke,ACC,10,43,571,13.3,2,1,1,1.0,0,44,572,13.0,2
190,Bucky Hodges,Virginia Tech,ACC,12,40,530,13.3,6,5,27,5.4,1,45,557,12.4,7
191,Jalin Marshall,Ohio State,Big Ten,12,36,477,13.3,5,2,30,15.0,0,38,507,13.3,5
192,Ronnie Moore,Bowling Green State,MAC,14,72,951,13.2,6,9,55,6.1,1,81,1006,12.4,7
193,Terenn Houk,Brigham Young,Ind,10,37,490,13.2,2,0,0,,0,37,490,13.2,2
194,Sam Browning,Eastern Michigan,MAC,8,24,316,13.2,3,2,27,13.5,0,26,343,13.2,3
195,Ron Willoughby,Buffalo,MAC,12,62,813,13.1,6,0,0,,0,62,813,13.1,6
196,Callen Hightower,Idaho,Sun Belt,11,57,749,13.1,2,2,12,6.0,0,59,761,12.9,2
197,Phil Mayhue,Memphis,American,13,51,670,13.1,1,1,4,4.0,0,52,674,13.0,1
198,Mark Chapman,Central Michigan,MAC,12,43,564,13.1,1,9,74,8.2,1,52,638,12.3,2
199,Deon Watson,Idaho,Sun Belt,11,42,551,13.1,7,0,0,,0,42,551,13.1,7
200,Jordan Leggett,Clemson,ACC,15,40,525,13.1,8,0,0,,0,40,525,13.1,8
201,Malik Turner,Illinois,Big Ten,11,39,510,13.1,3,0,0,,0,39,510,13.1,3
202,Josh Malone,Tennessee,SEC,10,31,405,13.1,2,0,0,,0,31,405,13.1,2
203,Trent Cowan,Idaho,Sun Belt,12,48,624,13.0,4,0,0,,0,48,624,13.0,4
204,Cortez Lewis,Wake Forest,ACC,12,47,611,13.0,4,0,0,,0,47,611,13.0,4
205,David Richards,Arizona,Pac-12,13,42,547,13.0,6,0,0,,0,42,547,13.0,6
206,Macgarrett Kings Jr.,Michigan State,Big Ten,13,40,519,13.0,5,4,15,3.8,0,44,534,12.1,5
207,Brandon Lingen,Minnesota,Big Ten,10,33,428,13.0,3,0,0,,0,33,428,13.0,3
208,Robert Wheelwright,Wisconsin,Big Ten,8,32,416,13.0,4,0,0,,0,32,416,13.0,4
209,Jaylen Smith,Louisville,ACC,10,29,376,13.0,1,0,0,,0,29,376,13.0,1
210,Torii Hunter Jr,Notre Dame,Ind,13,28,363,13.0,2,5,16,3.2,0,33,379,11.5,2
211,Devin Ross,Colorado,Pac-12,11,25,324,13.0,2,1,3,3.0,0,26,327,12.6,2
212,Trent Taylor,Louisiana Tech,CUSA,13,99,1282,12.9,9,0,0,,0,99,1282,12.9,9
213,Trent Sherfield,Vanderbilt,SEC,12,51,659,12.9,3,4,55,13.8,0,55,714,13.0,3
214,Imani Davis,Akron,MAC,11,46,593,12.9,3,4,15,3.8,0,50,608,12.2,3
215,DaeSean Hamilton,Penn State,Big Ten,13,45,580,12.9,6,0,0,,0,45,580,12.9,6
216,Austin Hooper,Stanford,Pac-12,12,34,438,12.9,6,0,0,,0,34,438,12.9,6
217,Ed'Marques Batties,Middle Tennessee State,CUSA,13,82,1048,12.8,13,0,0,,0,82,1048,12.8,13
218,Jordan Williams,Ball State,MAC,12,72,920,12.8,8,0,0,,0,72,920,12.8,8
219,Bralon Addison,Oregon,Pac-12,13,63,804,12.8,10,17,84,4.9,2,80,888,11.1,12
220,Ryan Switzer,North Carolina,ACC,14,54,693,12.8,6,4,10,2.5,0,58,703,12.1,6
221,Jake Butt,Michigan,Big Ten,13,51,654,12.8,3,0,2,,0,51,656,12.9,3
222,Nate Phillips,Arizona,Pac-12,13,43,549,12.8,4,0,0,,0,43,549,12.8,4
223,Roderick Proctor,Memphis,American,11,26,332,12.8,0,3,-6,-2.0,0,29,326,11.2,0
224,Daniel Braverman,Western Michigan,MAC,13,108,1367,12.7,13,2,13,6.5,0,110,1380,12.5,13
225,Alex Erickson,Wisconsin,Big Ten,13,77,978,12.7,3,7,111,15.9,0,84,1089,13.0,3
226,Antwane Grant,Western Kentucky,CUSA,14,55,701,12.7,7,3,65,21.7,1,58,766,13.2,8
227,Kenny Lawler,California,Pac-12,12,52,658,12.7,13,2,15,7.5,0,54,673,12.5,13
228,Durron Neal,Oklahoma,Big 12,13,44,559,12.7,3,0,0,,0,44,559,12.7,3
229,Mitchell Juergens,Brigham Young,Ind,12,37,471,12.7,2,3,11,3.7,0,40,482,12.1,2
230,Andre Patton,Rutgers,Big Ten,11,34,432,12.7,1,0,0,,0,34,432,12.7,1
231,Joe Mixon,Oklahoma,Big 12,13,28,356,12.7,4,113,753,6.7,7,141,1109,7.9,11
232,Demarcus Ayers,Houston,American,14,97,1221,12.6,6,26,148,5.7,1,123,1369,11.1,7
233,Christian Kirk,Texas A&M,SEC,13,80,1009,12.6,7,11,54,4.9,0,91,1063,11.7,7
234,Deandre Reaves,Marshall,CUSA,13,56,705,12.6,4,0,0,,0,56,705,12.6,4
235,David Morgan,UTSA,CUSA,12,45,566,12.6,5,0,0,,0,45,566,12.6,5
236,Dwayne Washington,Washington,Pac-12,8,25,315,12.6,3,47,282,6.0,4,72,597,8.3,7
237,Richie James,Middle Tennessee State,CUSA,13,107,1334,12.5,8,13,158,12.2,1,120,1492,12.4,9
238,Amara Darboh,Michigan,Big Ten,13,58,727,12.5,5,2,2,1.0,0,60,729,12.2,5
239,Alex Chisum,Cincinnati,American,12,38,475,12.5,1,0,0,,0,38,475,12.5,1
240,Dezmon Epps,Idaho,Sun Belt,6,61,757,12.4,2,0,0,,0,61,757,12.4,2
241,Max McCaffrey,Duke,ACC,13,52,643,12.4,5,0,0,,0,52,643,12.4,5
242,Chris Brown,Notre Dame,Ind,13,48,597,12.4,4,0,0,,0,48,597,12.4,4
243,Ricky Seals-Jones,Texas A&M,SEC,13,45,560,12.4,4,0,0,,0,45,560,12.4,4
244,Jafus Gaines,Texas State,Sun Belt,12,42,521,12.4,2,1,5,5.0,0,43,526,12.2,2
245,D'Vario Montgomery,Iowa State,Big 12,10,27,335,12.4,3,0,0,,0,27,335,12.4,3
246,Davonte Allen,Marshall,CUSA,12,58,715,12.3,5,0,0,,0,58,715,12.3,5
247,Thomas Owens,Florida International,CUSA,10,52,638,12.3,8,0,0,,0,52,638,12.3,8
248,Teldrick Morgan,New Mexico State,Sun Belt,9,44,543,12.3,4,4,11,2.8,0,48,554,11.5,4
249,Simms McElfresh,Appalachian State,Sun Belt,11,38,466,12.3,6,8,76,9.5,1,46,542,11.8,7
250,Steven Dunbar,Houston,American,12,31,382,12.3,3,0,0,,0,31,382,12.3,3
251,Markell Pack,Ole Miss,SEC,10,31,380,12.3,3,2,2,1.0,0,33,382,11.6,3
252,Wyatt Houston,Utah State,MWC,10,25,307,12.3,3,0,0,,0,25,307,12.3,3
253,Johnny Jackson,Arizona,Pac-12,12,50,612,12.2,5,0,0,,0,50,612,12.2,5
254,Billy Freeman,San Jose State,MWC,12,48,586,12.2,6,0,0,,0,48,586,12.2,6
255,Cam Serigne,Wake Forest,ACC,12,46,562,12.2,4,0,0,,0,46,562,12.2,4
256,Evan Engram,Ole Miss,SEC,12,38,464,12.2,2,0,0,,0,38,464,12.2,2
257,Kalib Woods,Florida Atlantic,CUSA,9,27,330,12.2,3,0,0,,0,27,330,12.2,3
258,Stanley Morgan Jr.,Nebraska,Big Ten,11,25,304,12.2,3,0,0,,0,25,304,12.2,3
259,Britain Covey,Utah,Pac-12,12,43,519,12.1,4,6,4,0.7,0,49,523,10.7,4
260,Trevon Brown,East Carolina,American,9,41,496,12.1,4,0,0,,0,41,496,12.1,4
261,Levern Jacobs,Maryland,Big Ten,10,35,425,12.1,3,2,8,4.0,0,37,433,11.7,3
262,Dameon Gamblin,New Mexico,MWC,12,35,424,12.1,2,9,51,5.7,0,44,475,10.8,2
263,Johnell Barnes,Duke,ACC,10,34,411,12.1,2,0,0,,0,34,411,12.1,2
264,J'Mon Moore,Missouri,SEC,11,29,350,12.1,3,0,0,,0,29,350,12.1,3
265,Nate Brown,Missouri,SEC,10,27,326,12.1,4,0,0,,0,27,326,12.1,4
266,Sebastian Smith,Ohio,MAC,13,65,777,12.0,7,0,0,,0,65,777,12.0,7
267,Mitchell Paige,Indiana,Big Ten,13,57,684,12.0,6,3,11,3.7,0,60,695,11.6,6
268,Kendal Keys,UNLV,MWC,12,43,515,12.0,6,0,0,,0,43,515,12.0,6
269,Jaquan White,UTEP,CUSA,12,41,494,12.0,7,3,10,3.3,0,44,504,11.5,7
270,Brandon Holloway,Mississippi State,SEC,13,33,396,12.0,5,92,413,4.5,0,125,809,6.5,5
271,Tajae Sharpe,Massachusetts,MAC,12,111,1319,11.9,5,1,-3,-3.0,0,112,1316,11.8,5
272,Carlos Harris,North Texas,CUSA,12,61,727,11.9,7,5,18,3.6,0,66,745,11.3,7
273,Jaydon Mickens,Washington,Pac-12,13,58,692,11.9,2,7,44,6.3,1,65,736,11.3,3
274,Max Morrison,Cincinnati,American,13,52,617,11.9,3,0,0,,0,52,617,11.9,3
275,Cam Phillips,Virginia Tech,ACC,13,49,582,11.9,2,1,24,24.0,0,50,606,12.1,2
276,Darius Powe,California,Pac-12,13,47,560,11.9,8,0,0,,0,47,560,11.9,8
277,Marken Michel,Massachusetts,MAC,9,31,370,11.9,4,7,46,6.6,0,38,416,10.9,4
278,Nelson Spruce,Colorado,Pac-12,13,89,1053,11.8,4,0,0,,0,89,1053,11.8,4
279,Hunter Sharp,Utah State,MWC,11,71,835,11.8,9,8,20,2.5,0,79,855,10.8,9
280,Ajalen Holley,Louisiana-Monroe,Sun Belt,12,61,720,11.8,7,1,4,4.0,0,62,724,11.7,7
281,Dylan Collie,Hawaii,MWC,11,29,342,11.8,1,1,0,0.0,0,30,342,11.4,1
282,C.J. Prosise,Notre Dame,Ind,10,26,308,11.8,1,157,1029,6.6,11,183,1337,7.3,12
283,Brayden Lenius,Washington,Pac-12,10,26,307,11.8,3,0,0,,0,26,307,11.8,3
284,Todd Boyd,Georgia State,Sun Belt,10,25,296,11.8,2,1,9,9.0,0,26,305,11.7,2
285,Calvin Ridley,Alabama,SEC,15,89,1045,11.7,7,1,2,2.0,0,90,1047,11.6,7
286,Jamire Jordan,Fresno State,MWC,12,46,540,11.7,5,10,55,5.5,1,56,595,10.6,6
287,R.J. Shelton,Michigan State,Big Ten,14,43,503,11.7,4,24,127,5.3,0,67,630,9.4,4
288,Kenneth Scott,Utah,Pac-12,13,39,457,11.7,4,0,0,,0,39,457,11.7,4
289,Tommylee Lewis,Northern Illinois,MAC,9,34,398,11.7,3,8,20,2.5,0,42,418,10.0,3
290,Devan Stubblefield,Hawaii,MWC,10,30,351,11.7,4,0,0,,0,30,351,11.7,4
291,Casey Martin,Southern Mississippi,CUSA,14,80,925,11.6,7,1,-5,-5.0,0,81,920,11.4,7
292,Quinshad Davis,North Carolina,ACC,14,55,638,11.6,4,0,0,,0,55,638,11.6,4
293,River Cracraft,Washington State,Pac-12,10,53,615,11.6,4,0,0,,0,53,615,11.6,4
294,Marcus McGill,Buffalo,MAC,11,50,581,11.6,4,1,10,10.0,0,51,591,11.6,4
295,Daikiel Shorts,West Virginia,Big 12,13,44,511,11.6,5,0,0,,0,44,511,11.6,5
296,Stephen Anderson,California,Pac-12,12,41,474,11.6,2,0,0,,0,41,474,11.6,2
297,Henry Krieger-Coble,Iowa,Big Ten,13,35,405,11.6,1,0,0,,0,35,405,11.6,1
298,Steven Sims Jr.,Kansas,Big 12,11,30,349,11.6,2,1,-9,-9.0,0,31,340,11.0,2
299,David Grinnage,North Carolina State,ACC,10,25,290,11.6,3,0,0,,0,25,290,11.6,3
300,Dontrell Hilliard,Tulane,American,12,23,267,11.6,1,115,646,5.6,6,138,913,6.6,7
301,Gabe Marks,Washington State,Pac-12,13,104,1192,11.5,15,0,0,,0,104,1192,11.5,15
302,Kody Kohl,Arizona State,Pac-12,12,32,368,11.5,4,0,28,,1,32,396,12.4,5
303,Fred Ross,Mississippi State,SEC,13,88,1007,11.4,5,2,42,21.0,1,90,1049,11.7,6
304,Mose Frazier,Memphis,American,13,70,797,11.4,4,17,119,7.0,2,87,916,10.5,6
305,Robert Lewis,Washington State,Pac-12,13,43,490,11.4,1,0,0,,0,43,490,11.4,1
306,Tabari Hines,Wake Forest,ACC,12,32,366,11.4,3,3,-13,-4.3,0,35,353,10.1,3
307,Amir Carlisle,Notre Dame,Ind,12,31,351,11.3,1,6,38,6.3,0,37,389,10.5,1
308,Cameron Batson,Texas Tech,Big 12,12,29,327,11.3,1,1,2,2.0,0,30,329,11.0,1
309,Zay Jones,East Carolina,American,12,98,1099,11.2,5,1,-6,-6.0,0,99,1093,11.0,5
310,Jake Maulhardt,Wyoming,MWC,12,57,641,11.2,8,0,0,,0,57,641,11.2,8
311,Ryan Burbrink,Bowling Green State,MAC,13,56,627,11.2,4,1,7,7.0,1,57,634,11.1,5
312,Daje Johnson,Texas,Big 12,11,37,415,11.2,1,6,28,4.7,0,43,443,10.3,1
313,Dominique Heath,Kansas State,Big 12,13,28,313,11.2,3,3,17,5.7,0,31,330,10.6,3
314,Troy Fumagalli,Wisconsin,Big Ten,9,28,313,11.2,1,0,0,,0,28,313,11.2,1
315,Temi Alaka,Rice,CUSA,8,27,303,11.2,1,0,0,,0,27,303,11.2,1
316,John Johnson,Troy,Sun Belt,12,23,258,11.2,0,1,-17,-17.0,0,24,241,10.0,0
317,Ryheem Malone,SMU,American,11,23,258,11.2,2,0,0,,0,23,258,11.2,2
318,Ardarius Stewart,Alabama,SEC,15,63,700,11.1,4,5,14,2.8,0,68,714,10.5,4
319,Marcus Green,Louisiana-Monroe,Sun Belt,12,62,687,11.1,6,3,5,1.7,0,65,692,10.6,6
320,Tim White,Arizona State,Pac-12,12,57,633,11.1,8,2,69,34.5,0,59,702,11.9,8
321,Demarcus Robinson,Florida,SEC,12,47,520,11.1,2,2,3,1.5,0,49,523,10.7,2
322,Hayden Plinke,UTEP,CUSA,10,37,410,11.1,0,1,-1,-1.0,0,38,409,10.8,0
323,Gehrig Dieter,Bowling Green State,MAC,14,94,1033,11.0,10,1,-2,-2.0,0,95,1031,10.9,10
324,Jerico Richardson,Nevada,MWC,13,68,749,11.0,5,1,1,1.0,0,69,750,10.9,5
325,Jonnu Smith,Florida International,CUSA,8,36,397,11.0,4,0,0,,0,36,397,11.0,4
326,Shaq Washington,Cincinnati,American,13,90,982,10.9,6,0,0,,0,90,982,10.9,6
327,Dorian Baker,Kentucky,SEC,11,56,612,10.9,3,0,0,,0,56,612,10.9,3
328,Tim Crawley,San Jose State,MWC,12,39,424,10.9,5,4,4,1.0,0,43,428,10.0,5
329,Matt Vandeberg,Iowa,Big Ten,14,65,703,10.8,4,2,24,12.0,0,67,727,10.9,4
330,Von Pearson,Tennessee,SEC,12,38,409,10.8,3,4,-5,-1.3,0,42,404,9.6,3
331,Terry Godwin,Georgia,SEC,13,35,379,10.8,2,7,37,5.3,1,42,416,9.9,3
332,Jake Roh,Boise State,MWC,13,33,357,10.8,1,0,0,,0,33,357,10.8,1
333,Dan Vitale,Northwestern,Big Ten,12,33,355,10.8,4,0,0,,0,33,355,10.8,4
334,Xavier Castille,SMU,American,10,24,258,10.8,2,0,0,,0,24,258,10.8,2
335,Jesus Wilson,Florida State,ACC,13,58,622,10.7,3,3,11,3.7,0,61,633,10.4,3
336,Kerry Thomas,UTSA,CUSA,12,51,548,10.7,4,8,42,5.3,0,59,590,10.0,4
337,Shaun Nixon,TCU,Big 12,13,47,501,10.7,1,16,66,4.1,0,63,567,9.0,1
338,Emanuel Thompson,Troy,Sun Belt,11,28,299,10.7,3,0,0,,0,28,299,10.7,3
339,K.J. Maye,Minnesota,Big Ten,13,73,773,10.6,5,9,46,5.1,1,82,819,10.0,6
340,Kevonn Mabon,Ball State,MAC,12,70,745,10.6,2,2,-4,-2.0,0,72,741,10.3,2
341,Corey Jones,Toledo,MAC,12,55,577,10.5,5,4,27,6.8,0,59,604,10.2,5
342,Ito Smith,Southern Mississippi,CUSA,14,49,515,10.5,3,171,1128,6.6,10,220,1643,7.5,13
343,Dustin Creel,Eastern Michigan,MAC,11,43,451,10.5,6,0,0,,0,43,451,10.5,6
344,Clinton Taylor,Florida International,CUSA,12,37,387,10.5,3,1,4,4.0,0,38,391,10.3,3
345,Tyler Winston,San Jose State,MWC,8,35,368,10.5,2,0,0,,0,35,368,10.5,2
346,Chuck Wade,Wake Forest,ACC,11,33,348,10.5,1,1,-1,-1.0,0,34,347,10.2,1
347,Cody Tuttle,Eastern Michigan,MAC,12,33,348,10.5,0,1,-2,-2.0,0,34,346,10.2,0
348,Collin Lisa,Buffalo,MAC,11,31,325,10.5,2,0,0,,0,31,325,10.5,2
349,Rashon Ceaser,Louisiana-Monroe,Sun Belt,5,31,325,10.5,2,2,3,1.5,0,33,328,9.9,2
350,Brandon Burks,Troy,Sun Belt,12,29,304,10.5,2,201,1005,5.0,7,230,1309,5.7,9
351,Sherman Badie,Tulane,American,12,27,284,10.5,0,72,310,4.3,2,99,594,6.0,2
352,Kris Strange,Eastern Michigan,MAC,9,26,273,10.5,1,0,0,,0,26,273,10.5,1
353,Anthony Rice,Central Michigan,MAC,13,57,595,10.4,4,1,6,6.0,0,58,601,10.4,4
354,Al-Damion Riles,Louisiana,Sun Belt,11,46,477,10.4,4,1,4,4.0,0,47,481,10.2,4
355,Andrew Rodriguez,Utah State,MWC,13,27,281,10.4,1,0,0,,0,27,281,10.4,1
356,Sony Michel,Georgia,SEC,13,26,270,10.4,3,218,1136,5.2,8,244,1406,5.8,11
357,Jared Dangerfield,Western Kentucky,CUSA,13,82,844,10.3,8,0,0,,0,82,844,10.3,8
358,Arkeel Newsome,Connecticut,American,13,45,465,10.3,2,182,788,4.3,6,227,1253,5.5,8
359,Darren Andrews,UCLA,Pac-12,11,43,443,10.3,1,1,0,0.0,0,44,443,10.1,1
360,Richard Mullaney,Alabama,SEC,15,38,390,10.3,5,0,0,,0,38,390,10.3,5
361,Darreus Rogers,USC,Pac-12,10,28,289,10.3,3,1,1,1.0,0,29,290,10.0,3
362,Raekwon James,Kent State,MAC,12,28,287,10.3,0,76,261,3.4,0,104,548,5.3,0
363,Tyler Boyd,Pitt,ACC,12,91,926,10.2,6,40,349,8.7,0,131,1275,9.7,6
364,C.J. Best,Texas State,Sun Belt,10,58,591,10.2,1,16,98,6.1,1,74,689,9.3,2
365,Conner Floyd,Tulsa,American,13,45,458,10.2,3,2,-10,-5.0,0,47,448,9.5,3
366,Turner Smiley,North Texas,CUSA,9,25,255,10.2,1,1,10,10.0,0,26,265,10.2,1
367,Dondre Daley,Iowa State,Big 12,7,24,244,10.2,2,0,0,,0,24,244,10.2,2
368,Bryce Williams,East Carolina,American,12,58,583,10.1,4,0,0,,0,58,583,10.1,4
369,Austin Duke,Charlotte,CUSA,12,53,534,10.1,5,9,25,2.8,0,62,559,9.0,5
370,J.D. McKissic,Arkansas State,Sun Belt,13,52,525,10.1,2,18,112,6.2,0,70,637,9.1,2
371,Janarion Grant,Rutgers,Big Ten,12,35,352,10.1,1,8,80,10.0,0,43,432,10.0,1
372,Victor Bolden,Oregon State,Pac-12,12,46,461,10.0,3,36,185,5.1,0,82,646,7.9,3
373,Jauan Wesley,Iowa State,Big 12,10,30,301,10.0,2,3,7,2.3,0,33,308,9.3,2
374,Andrew Pratt,Akron,MAC,10,28,280,10.0,1,0,0,,0,28,280,10.0,1
375,Matt Weiser,Buffalo,MAC,12,63,625,9.9,3,0,0,,0,63,625,9.9,3
376,D.J. Foster,Arizona State,Pac-12,13,59,584,9.9,3,55,280,5.1,1,114,864,7.6,4
377,Jeremiah Booker,Kansas,Big 12,8,23,228,9.9,0,0,0,,0,23,228,9.9,0
378,Demario Richard,Arizona State,Pac-12,12,31,303,9.8,3,210,1104,5.3,7,241,1407,5.8,10
379,Cameron Posey,Purdue,Big Ten,10,26,255,9.8,1,0,0,,0,26,255,9.8,1
380,Artavis Scott,Clemson,ACC,15,93,901,9.7,6,6,20,3.3,1,99,921,9.3,7
381,Samajie Grant,Arizona,Pac-12,10,31,301,9.7,2,4,21,5.3,0,35,322,9.2,2
382,Ryan Carden,Texas State,Sun Belt,8,25,243,9.7,0,0,0,,0,25,243,9.7,0
383,Taquan Mizzell,Virginia,ACC,12,75,721,9.6,4,164,664,4.0,4,239,1385,5.8,8
384,Gabe Fuselier,Louisiana,Sun Belt,12,37,357,9.6,1,0,0,,0,37,357,9.6,1
385,Ervin Phillips,Syracuse,ACC,10,30,288,9.6,5,41,234,5.7,3,71,522,7.4,8
386,Ryan Yurachek,Marshall,CUSA,13,44,417,9.5,9,1,27,27.0,0,45,444,9.9,9
387,Jalen Richard,Southern Mississippi,CUSA,13,30,284,9.5,2,185,1098,5.9,14,215,1382,6.4,16
388,Kenyan Drake,Alabama,SEC,13,29,276,9.5,1,77,408,5.3,1,106,684,6.5,2
389,T.L. Ford,Charlotte,CUSA,11,26,247,9.5,0,0,3,,0,26,250,9.6,0
390,Deandre Washington,Texas Tech,Big 12,13,41,385,9.4,2,233,1492,6.4,14,274,1877,6.9,16
391,Deon-Tay McManus,Marshall,CUSA,12,36,337,9.4,1,0,0,,0,36,337,9.4,1
392,Larry Rose III,New Mexico State,Sun Belt,12,30,283,9.4,2,239,1657,6.9,14,269,1940,7.2,16
393,Desmond Cain,Illinois,Big Ten,12,53,492,9.3,1,1,5,5.0,0,54,497,9.2,1
394,Jake McGee,Florida,SEC,11,41,381,9.3,4,0,0,,0,41,381,9.3,4
395,Jaylen Samuels,North Carolina State,ACC,13,65,597,9.2,7,56,368,6.6,9,121,965,8.0,16
396,Alan Cross,Memphis,American,10,25,229,9.2,3,1,-2,-2.0,0,26,227,8.7,3
397,KeeSean Johnson,Fresno State,MWC,11,37,337,9.1,2,0,0,,0,37,337,9.1,2
398,Steven Mitchell,USC,Pac-12,12,37,335,9.1,4,0,0,,0,37,335,9.1,4
399,Jared Mapps,Louisiana-Monroe,Sun Belt,8,26,236,9.1,1,0,0,,0,26,236,9.1,1
400,Jeremy McNichols,Boise State,MWC,12,51,460,9.0,6,240,1337,5.6,20,291,1797,6.2,26
401,Marcus Smith,North Texas,CUSA,11,29,261,9.0,0,0,0,,0,29,261,9.0,0
402,Elijah McGuire,Louisiana,Sun Belt,12,34,304,8.9,3,209,1047,5.0,13,243,1351,5.6,16
403,Jamal Morrow,Washington State,Pac-12,11,33,294,8.9,4,53,347,6.5,0,86,641,7.5,4
404,Steven Scheu,Vanderbilt,SEC,9,27,240,8.9,1,0,0,,0,27,240,8.9,1
405,Elijhaa Penny,Idaho,Sun Belt,12,27,239,8.9,2,246,1159,4.7,10,273,1398,5.1,12
406,Aregeros Turner,Northern Illinois,MAC,14,39,343,8.8,1,24,152,6.3,1,63,495,7.9,2
407,Travis Greene,Bowling Green State,MAC,14,27,237,8.8,2,222,1298,5.8,15,249,1535,6.2,17
408,Jalen McCleskey,Oklahoma State,Big 12,13,29,253,8.7,3,4,25,6.3,0,33,278,8.4,3
409,Ray-Ray McCloud,Clemson,ACC,12,29,251,8.7,1,7,48,6.9,0,36,299,8.3,1
410,Alvin Kamara,Tennessee,SEC,13,34,291,8.6,3,107,698,6.5,7,141,989,7.0,10
411,Wyatt Demps,Nevada,MWC,11,27,232,8.6,0,0,0,,0,27,232,8.6,0
412,Lajuan Hunt,Utah State,MWC,13,27,231,8.6,1,106,338,3.2,5,133,569,4.3,6
413,Devontae Booker,Utah,Pac-12,10,37,316,8.5,0,268,1261,4.7,11,305,1577,5.2,11
414,Tyler Patrick,Kansas,Big 12,10,30,255,8.5,2,0,0,,0,30,255,8.5,2
415,Shane Williams-Rhodes,Boise State,MWC,11,62,521,8.4,0,13,102,7.8,1,75,623,8.3,1
416,Corey Lacanaria,Ball State,MAC,10,45,376,8.4,2,0,0,,0,45,376,8.4,2
417,D.J. Vinson,South Alabama,Sun Belt,11,23,193,8.4,0,3,5,1.7,1,26,198,7.6,1
418,Dare Ogunbowale,Wisconsin,Big Ten,13,36,299,8.3,1,194,819,4.2,7,230,1118,4.9,8
419,Anthony Wales,Western Kentucky,CUSA,11,27,225,8.3,2,154,1086,7.1,9,181,1311,7.2,11
420,Aaron Grubb,UTSA,CUSA,11,42,344,8.2,3,12,56,4.7,0,54,400,7.4,3
421,Joshua Bowen,New Mexico State,Sun Belt,10,29,239,8.2,2,0,0,,0,29,239,8.2,2
422,Paul Perkins,UCLA,Pac-12,13,30,242,8.1,1,237,1343,5.7,14,267,1585,5.9,15
423,Henry Bussey,Florida Atlantic,CUSA,12,29,236,8.1,0,14,65,4.6,0,43,301,7.0,0
424,Phillip Lindsay,Colorado,Pac-12,13,27,216,8.0,1,141,658,4.7,6,168,874,5.2,7
425,Xavier Jones,SMU,American,12,28,219,7.8,0,150,632,4.2,10,178,851,4.8,10
426,Ralph Webb,Vanderbilt,SEC,12,24,188,7.8,2,277,1152,4.2,5,301,1340,4.5,7
427,Josh Ferguson,Illinois,Big Ten,9,37,280,7.6,2,129,708,5.5,3,166,988,6.0,5
428,Ezekiel Elliott,Ohio State,Big Ten,13,27,206,7.6,0,289,1821,6.3,23,316,2027,6.4,23
429,Jamal Wilson,Massachusetts,MAC,12,24,182,7.6,1,86,377,4.4,6,110,559,5.1,7
430,Danny Anthrop,Purdue,Big Ten,12,57,430,7.5,2,2,-4,-2.0,0,59,426,7.2,2
431,Alex Gardner,Florida International,CUSA,12,60,442,7.4,1,186,760,4.1,9,246,1202,4.9,10
432,Tyler Ervin,San Jose State,MWC,13,45,334,7.4,2,294,1601,5.4,13,339,1935,5.7,15
433,Keith Harrington,Washington State,Pac-12,13,43,312,7.3,3,37,238,6.4,2,80,550,6.9,5
434,Kyrin Priester,Washington State,Pac-12,13,33,241,7.3,1,1,5,5.0,0,34,246,7.2,1
435,D.J. Knox,Purdue,Big Ten,10,26,189,7.3,0,108,409,3.8,2,134,598,4.5,2
436,Chris Shillings,Ball State,MAC,9,26,186,7.2,1,0,0,,0,26,186,7.2,1
437,Markell Jones,Purdue,Big Ten,12,34,239,7.0,1,168,875,5.2,10,202,1114,5.5,11
438,Warren Redix,UTEP,CUSA,10,29,202,7.0,1,23,136,5.9,0,52,338,6.5,1
439,Gary Haynes,Louisiana,Sun Belt,8,25,174,7.0,0,0,0,,0,25,174,7.0,0
440,Demetrius Frazier,Middle Tennessee State,CUSA,12,28,191,6.8,1,2,12,6.0,0,30,203,6.8,1
441,Chris Hairston,East Carolina,American,12,29,193,6.7,1,165,754,4.6,8,194,947,4.9,9
442,Shaq Vann,Eastern Michigan,MAC,12,34,221,6.5,1,102,611,6.0,5,136,832,6.1,6
443,Tra Carson,Texas A&M,SEC,13,29,183,6.3,1,242,1165,4.8,7,271,1348,5.0,8
444,Wendell Smallwood,West Virginia,Big 12,13,26,160,6.2,0,238,1519,6.4,9,264,1679,6.4,9
445,Shaquille Powell,Duke,ACC,13,35,212,6.1,2,124,538,4.3,3,159,750,4.7,5
446,Marcus Davis,Auburn,SEC,13,30,181,6.0,1,1,-8,-8.0,0,31,173,5.6,1
447,Gerard Wicks,Washington State,Pac-12,13,38,128,3.4,0,107,610,5.7,3,145,738,5.1,3
